____PP____
___G__G___
___G__G___
__WW__WW__
_RRR__RRR_
__YY__YY__